######
#....#
#...T#
#.K..#
###E##
